wwwwwwwwww
w     ]wgw
w S bwww w
w     b  w
w  b     w
w   ]   cw
w  wwwwwww
w    [  gw
wg     b w
wwwwwwwwww