wwwwwwwwwwwwwwww
w           m  w
w  b [   [    ww
wwwwww       wcw
w    w b   ]w  w
w  S w b   ]w  w
w  www v]   w  w
w [      gg    w
wg     R       w
wwwwwwwwwwwwwwww